!############!
#^^^^+H*****H#
#^^^******%**#
#^^**********#
#^B*******+###
#H**K******L&#
!############!