############################
#H******?******.......*****#
#**+***********~~~~~~.*+***#
#...^**L**@****.......*****#
#**.......#######.*****@***#
#**+**~.*K#&....#.*?*K*****#
#*****~.K*#..%.+#.******@**#
#*****~##########..*?******#
#B***@*~~~~~~~~@*...****K**#
#**?****~~~~~~*************#
#*****+*@*~~~***+*K***+****#
#**************************#
############################