###########
#+*******+#
#**#*###**#
#*#*#%*+#*#
#+#*#*#^#*#
#*#*##**#+#
#+**@**#&*#
###########