###########
#+*******+#
#**#*###**#
#*#*#%*+#*#
#+#*#*#*#*#
#*#*##**#+#
#+*****#&*#
###########