####!##########!############
#******@******@.......*****#
!**+***********~~~~~~.*+***#
#*********@****.......*****#
#*********!#####!******@***#
#**+**~.*%#&****#**********!
!*****~.**#****+#*******@**#
#*****~.**!#####!**********#
#****@*********@***********#
!**************************!
#*****+*@*******+*****+****#
#**************************#
#############!#######!######